NO assets/xpm/d_first.xpm   assets/xpm/monsterface.xpm     assets/xpm/DirtyWall.xpm
SO assets/xpm/d_second.xpm  assets/xpm/WallSignsDark.xpm    assets/xpm/WallSigns.xpm
WE assets/xpm/d_third.xpm   assets/xpm/WallDark256.xpm assets/xpm/Wall256.xpm
EA assets/xpm/d_last.xpm    assets/xpm/MonaLisaDark.xpm     assets/xpm/MonaLisa.xpm
DR assets/xpm/PoolPortal.xpm
MN assets/xpm/New-Project.xpm
OB assets/xpm/smartBroke.xpm
EN assets/xpm/Smiller.xpm

F 120,6,6
C 104,96,107

11111111111111111111111111111111111111111111111111111111111111111111111111111111111111111111111111111111111111111111111111111111111111111111111111111111111111111111111111111111111111111111111111111111111111111111111111111111
11111111111111111000000000000000000000000000000000000000000000000000000000000000000000000000000000000000000000000000000000000000000000000000000000000000000000000000000000000000000000000000000000000000000000000000000000000011
101000100010001000100000000000000000000000000000000000000000000000000000000000000000000000000000000000000000000000000000000000000000000000000000000000000000000000000000000000000000000000000000000000000000000300000000E000011
10001000100010001020000000000000000000000000000000000000000000000000000000000000000000000000000000000000000000000000000000000000000000000000000000000000000000000000000000000000000000000000000000000000000000000000000000000011
10100010001000100000011111111111111111111111111111111111111111111111111111111111111111111111111111111111111111111111111111111111111111111111111111111111111111111111111111111111111111111111111111111111111111111111111111111111111
10001000100010001000001
1001 1010101 101 100001
10001000100010001002001
10010001000100010001001
10111011101110111011101
10010001000100010001001
10000100010001000100001
10001110111011101110001
10000100010001000100001
10100010000000010001001
10110111011110111010101
1010001001  10010001001
1000000001  10000000001
10000000011110000000001
10010001100001100000001
10001000001100000000001
10000100010010001000001
10000010000000010000001
10000001000000100000001
10000100001100000100001
10001110010010001010001
10000000000000000000001
11111111111111111111111