NO assets/xpm/Blue_title.xpm   assets/xpm/monsterface.xpm     assets/xpm/DirtyWall.xpm
SO assets/xpm/Red_Wall.xpm  assets/xpm/WallSignsDark.xpm    assets/xpm/WallSigns.xpm
WE assets/xpm/Red_Title.xpm   assets/xpm/WallDark256.xpm    assets/xpm/Wall256.xpm
EA assets/xpm/Blue-Wall.xpm   assets/xpm/MonaLisaDark.xpm     assets/xpm/MonaLisa.xpm
MN assets/xpm/player.xpm
DR assets/xpm/Portal3.xpm
OB assets/xpm/LiGun2.xpm
EN assets/xpm/Smiller.xpm

F  53,81,92
C 104,96,107

111111111111111111111111111111111111111111111111111111111111111111111111111111111111111111111111111111111111111111111111111111111111111111111111111111111111111111111111111111111111111111111111111111111111111111111111111111111111
100000100010001000100000000000300000000000100300010000030000001000000030000000000000000000000000000000000000000000000000000000000000000000000000000000000000000000000000000000000000000000000000000000000000000000000000000000011
100010001000100130200E0000000300000000000000100030000010000003000000010000000000000000000000000000000000000000000000000000000000000000000000000000000000000000000000000000000000000000000000000000000000000000000000000000000011
10100010001000100010011111111111111111111111111111111111111111111111111111111111111111111111111111111111121111111111111111111111111111111111111111111111111111111111111111111111111111111111111111111111111111111111111111111111111
1000100010001000100001                                                                                  101
1001 1010101 101 101001                                                                                 101
100010001000100010020001                                                                                10111111111111
1001000100010001000100001                                                                               10200000030001
10111011101110111011100001                                                                              10111111111111
100100010001000100010000001                                                                             101
1000010001000100010000000001                                                                            121
10001110111011101110000000001111111111111111111111111111111111111111111111111111111111111111111111111111001
10000100010001000100000000000000000000000000000000000000000000000000000000000000000000000000000000000000001
10100010000000010001000000000011111111111111111111111111111111111111111111111111111111111111111111111111101
10110111011110111010100000000001                                                                        101
1010001001  100100010000000000001                                                                       101
1000000001  1000000000000000000001                                                                      101
10000000011110000000000000000000001                                                                     101
100100011000011000000000000000000001                                                                    101
1000100000110000000000000000000000001                                                                   101
10000100010010001000000000000000000001                                                                  101
100000100000000100000000000000000000001                                                                 101
1000000100000010000000000000000000000001                                                                101
10000100001100000100000000000000000000001                                                               101
100011100100100010100000000000000000000001                                                              101
1000000000000000000000000000000000000000001                                                             101
111111111111111111111111111111111111111111111111111111111111111111111111111111111111111111111111111111111111111111111111111111111111111111