
NO assets/xpm/trollmonster.xpm
SO assets/xpm/monsterface.xpm
WE assets/xpm/runhighxpm.xpm
EA assets/xpm/monaxpm.xpm


F 230,100,0
C 225,30,0


111111111111111111111
100000000000000000001
100000000000000000001
100000000000000000001
100000000000000000001
1000000000N0000000001
100000000000000000001
100000000000000000001
100000000000000000001
100000000000000000001
100000000111100000001
1000000001  100000001
1000000001  100000001
100000000111100000001
100000000000000000001
100000000000000000001
100000000000000000001
100000000000000000001
100000000000000000001
100000000000000000001
100000000000000000001
100000000000000000001
111111111111111111111