
NO assets/xpm/exit1.xpm
SO assets/xpm/RunRed.xpm
WE assets/xpm/Monster-Wall.xpm
EA assets/xpm/ClawMarks.xpm


F 230,100,0
C 225,30,0


        1111111111  1111111111111
        1000000000110000000000001 
        1011000001110000000000001
        10010000000000000000N0001
111111111011000001110000000000001
100000000011000000010111111111111
11110000000000011000000010001
11110000000111011101010010001
10000000110101011100000010001
10100000000000001100000010001
10100000000000001101010010001
1110000111010101111101111000111
11110111 1110101 101111010001
11111111 1111111 111111111111