
NO assets/xpm/trollmonster.xpm
SO assets/xpm/monsterface.xpm
WE assets/xpm/runhighxpm.xpm
EA assets/xpm/monaxpm.xpm


F 230,100,0
C 225,30,0


111111111111111111111111111111111111111111111111111111111111111111111111111111111111111111111111111111111111111111111111111111111
10100010001000100010000100000010000000000000100010001000100001000100010001000100001000100010001000100001000100010001000100011
1000100010001000100000000010000001000100001000100010001000100001000100010001000100001000100010001000100001000100010001000100011
101000100010001000100011111111111111111111111111111111111111111111111111111111111111111111111111111111111111111111111111111111111
10001000100010001000001
1001 1010101 101 100001
10001000100010001000001
10010001000100010001001
10111011101110111011101
10010001000100010001001
10000100010001000100001
10001110111011101110001
10000100010001000100001
10100010000000010001001
10110111011110111010101
1010001001  10010001001
1000000001  10000000001
10000000011110000000001
10010001100001100000001
10001000001100000000001
10000100010010001000001
10000010000000010000001
10000001000000100000001
10000100001100000100001
10001110010010001010001
100000000000000000000S1
11111111111111111111111