
NO assets/xpm/black_wall.xpm
SO assets/xpm/maestro.xpm
WE assets/xpm/normal_wall.xpm
EA assets/xpm/wall_white.xpm


F 230,100,0
C 225,30,0


        1111111111  1111111111111
        1000000000110000000000001 
        1011000001110000000000001
        1001000000000000000000001
111111111011000001110000000000001
100100000011000001110111111111111
11110111111111011100000010001
11110111111111011101010010001
11000000110101011100000010001
10100000000000001100000010001
10100000000000001101010010001
1110000111010101111101111000111
11110111 1110101 101111010001
11111111 1111111 111111111111