
NO assets/xpm/pool.xpm
SO assets/xpm/pool.xpm
WE assets/xpm/pool.xpm
EA assets/xpm/pool.xpm


F 230,100,0
C 225,30,0


11111111111111111111111
10100010001000100010001
10001000100010001000001
10100010001000100010001
10001000100010001000001
1001 1010101 101 100001
10001000100010001000001
10010001000100010001001
10111011101110111011101
10010001000100010001001
10000100010001000100001
10001110111011101110001
10000100010001000100001
10100010000000010001001
10110111011110111010101
1010001001  10010001001
1000000001  10000000001
10000000011110000000001
10010001100001100000001
10001000001100000000001
10000100010010001000001
10000010000000010000001
10000001000000100000001
10000100001100000100001
10001110010010001010001
100000000000000000000S1
11111111111111111111111